30 20
e0e0a0b4b0a0c0d0a4c0d2b0b0b4c0d0b0c0d0c4a0b0e0b4e0a4c0d0b0a
0-2-0-0-4-0-0-0-2-0-0-2-2-0-0-2-0-0-0-2-0-0-0-0-4-0-0-0-2-2
a0b2a0c2b0c2d0c0c4c0a0c0d2a0b4a0b0c0a0a0a4b2d0b2b0a0d0a0d4d
0-0-0-0-0-0-2-0-2-0-2-0-0-0-0-0-0-0-2-0-0-0-0-4-4-0-0-2-0-0
a4a0c2a0b2a0a0b2b0c0c0b0a0a0c2d0a0b0b4c0c0d0a0a0a4b0c0d0d0a
0-0-4-0-0-4-0-0-0-0-4-0-0-4-0-0-0-0-4-0-0-0-0-0-0-0-2-4-2-0
b0a0a2c2c0b0a0c0b0a2a0c0d0e4e2b0a2a4d0a0a0a0a0c0b0d0d0d0b0c
0-0-4-0-0-2-0-0-0-0-0-0-0-0-0-0-4-0-0-0-0-4-2-0-0-0-0-0-0-0
b4b0c4d0d0c0d0d0c0a0b2a0d0a0d0a0b0c0e0e2b0a4d0a0c0a0c2c0a0a
0-0-2-2-4-0-0-0-0-4-0-0-0-0-4-0-0-0-0-0-4-0-0-0-0-0-0-2-0-2
c2a2b4b4d0d0c0c0b0c0a0e0e0b2b0a0c0c0b2a2c0d0e2c0a0d0c2b2c0a
2-0-0-0-4-4-0-0-0-2-4-0-0-0-0-4-0-0-0-0-0-2-0-0-0-0-2-0-0-2
c0c0c0a0d0a2a0b2b2a0c0a0d0c0c2c0a4a0c0a0a2a0d0d4d0a4b2c2b0c
0-2-0-4-0-0-0-2-0-2-4-0-2-0-2-2-0-0-0-0-0-0-2-0-0-0-0-0-2-0
a0a2a4d0d0c2a0d0a0a0a4e0d0e2c0d0c4a0c0c0a0b2a4c0a0d2a0c0c0a
0-0-0-0-0-0-2-0-0-0-0-0-0-2-0-0-0-0-2-0-0-0-4-4-0-0-4-2-2-2
c0a0a0b4c0d0d2b4d0a0a0a0b2a0b0a0c0a0c0a4c4d0b0a0a2e2a0a0e0c
0-0-0-0-0-4-0-0-0-0-0-0-0-4-4-0-0-0-0-2-0-0-0-0-0-0-2-4-0-2
d0b0c0a2b0b0a0a2c0c0d0e0a0d0a0a0a0b0c0d0a0c2a0a0d0a0b0d2a0c
0-0-0-0-0-0-0-0-0-0-0-0-0-0-0-0-0-0-0-0-0-0-2-0-0-0-2-0-0-2
c0a0a2c0a4b0b0c0b0b0a2d4a0e0d0b0c0b2c4a0a0a0a2c0b0a0d0a0b2a
2-0-4-0-0-0-0-0-2-0-4-0-0-4-0-0-0-2-0-0-0-4-0-2-4-2-4-2-0-0
b0c4d0a0c2a4a0a0c0b0a0b0c2a0a0b4a0c0a0a0c0c2b0a0a0a2b0d0b0a
0-0-4-4-0-0-0-0-2-4-0-0-2-0-0-2-0-0-0-4-0-0-0-0-0-0-0-0-0-0
b0a2e0b0c4b0b0a0a0a2a2c0d2b4c0c0e0e0b4a0a0d0b0a0a0b0a4b4c0c
0-0-4-0-0-4-2-0-0-0-0-0-0-0-0-2-0-4-0-0-0-0-2-0-0-4-4-0-0-0
b0d0c2a2c2e0c0c0c0c4a0c4c0a0b0c0b0c2a0d0a0c0c2b0a4c0d2e0a4b
0-0-2-0-0-0-0-0-0-4-0-2-4-0-0-0-0-4-0-0-0-0-0-0-0-0-0-0-2-2
b0a2d0d0a2c0a2c4c4c0a0b0a0a0d0c2c0e0b0a0b0a0d0e0b0a0e0c0a2b
0-0-0-0-4-2-0-4-0-0-2-0-0-0-0-0-0-0-0-0-0-0-0-2-2-0-0-0-0-0
e0b0b0d0c2b2a0c0a0c0c2c0a0b4e4b0a2a0a0c0c0b0c0b0e0b0d2d0c0a
4-0-0-2-0-0-4-2-0-2-0-0-0-4-0-0-2-0-0-0-0-0-0-0-0-0-0-0-4-0
d0d2a0c0a4d0b2b0e0e0a4c0a0d0a4b0b0a0b0c0c0a0a0d0a0d0b0b0a4b
0-0-0-2-0-2-0-0-0-0-0-0-0-2-2-0-4-0-2-0-0-2-0-4-0-0-0-4-0-0
d0a0a0b0b0c0a0c2d0b0c0d0b0a2a0a0a0d0d0a0d0d0c0a0c0c2c0b2a0b
2-0-0-0-0-2-0-0-0-2-0-0-0-0-0-0-0-0-0-0-0-0-0-0-0-2-2-0-0-0
a0a0a2a0a4a0c0d2e0a4c0a0c0c0c0c0c0d2a0a2a2c0c0d0b0d0a0d4b4a
0-4-0-0-0-0-0-0-0-2-2-0-4-0-0-0-0-0-0-2-0-0-0-0-0-0-0-0-0-0
b0a0a0a0a0a0a0b0b0c0a0a0b0d0b2a4c4a4c2d0b0c0a2e0c0b0b4a0c2a