50 50
a0b0c2d2e4a0b0c2d2e4a0b0c2d2e4a0b0c2d2e4a0b0c2d2e4a0b0c2d2e4a0b0c2d2e4a0b0c2d2e4a0b0c2d2e4a0b0c2d2e
3-4-0-4-4-3-4-0-4-4-3-4-0-4-4-3-4-0-4-4-3-4-0-4-4-3-4-0-4-4-3-4-0-4-4-3-4-0-4-4-3-4-0-4-4-3-4-0-4-4
c2a0b0b2e4c2a0b0b2e4c2a0b0b2e4c2a0b0b2e4c2a0b0b2e4c2a0b0b2e4c2a0b0b2e4c2a0b0b2e4c2a0b0b2e4c2a0b0b2e
2-2-2-2-2-2-2-2-2-2-2-2-2-2-2-2-2-2-2-2-2-2-2-2-2-2-2-2-2-2-2-2-2-2-2-2-2-2-2-2-2-2-2-2-2-2-2-2-2-2
e0b0b0b0e4e0b0b0b0e4e0b0b0b0e4e0b0b0b0e4e0b0b0b0e4e0b0b0b0e4e0b0b0b0e4e0b0b0b0e4e0b0b0b0e4e0b0b0b0e
0-0-0-4-0-0-0-0-4-0-0-0-0-4-0-0-0-0-4-0-0-0-0-4-0-0-0-0-4-0-0-0-0-4-0-0-0-0-4-0-0-0-0-4-0-0-0-0-4-0
e2a0c4b4e4e2a0c4b4e4e2a0c4b4e4e2a0c4b4e4e2a0c4b4e4e2a0c4b4e4e2a0c4b4e4e2a0c4b4e4e2a0c4b4e4e2a0c4b4e
0-0-2-4-2-0-0-2-4-2-0-0-2-4-2-0-0-2-4-2-0-0-2-4-2-0-0-2-4-2-0-0-2-4-2-0-0-2-4-2-0-0-2-4-2-0-0-2-4-2
e0b0c0a0e4e0b0c0a0e4e0b0c0a0e4e0b0c0a0e4e0b0c0a0e4e0b0c0a0e4e0b0c0a0e4e0b0c0a0e4e0b0c0a0e4e0b0c0a0e
4-4-4-4-4-4-4-4-4-4-4-4-4-4-4-4-4-4-4-4-4-4-4-4-4-4-4-4-4-4-4-4-4-4-4-4-4-4-4-4-4-4-4-4-4-4-4-4-4-4
a0b0c2d2e4a0b0c2d2e4a0b0c2d2e4a0b0c2d2e4a0b0c2d2e4a0b0c2d2e4a0b0c2d2e4a0b0c2d2e4a0b0c2d2e4a0b0c2d2e
3-4-0-4-4-3-4-0-4-4-3-4-0-4-4-3-4-0-4-4-3-4-0-4-4-3-4-0-4-4-3-4-0-4-4-3-4-0-4-4-3-4-0-4-4-3-4-0-4-4
c2a0b0b2e4c2a0b0b2e4c2a0b0b2e4c2a0b0b2e4c2a0b0b2e4c2a0b0b2e4c2a0b0b2e4c2a0b0b2e4c2a0b0b2e4c2a0b0b2e
2-2-2-2-2-2-2-2-2-2-2-2-2-2-2-2-2-2-2-2-2-2-2-2-2-2-2-2-2-2-2-2-2-2-2-2-2-2-2-2-2-2-2-2-2-2-2-2-2-2
e0b0b0b0e4e0b0b0b0e4e0b0b0b0e4e0b0b0b0e4e0b0b0b0e4e0b0b0b0e4e0b0b0b0e4e0b0b0b0e4e0b0b0b0e4e0b0b0b0e
0-0-0-4-0-0-0-0-4-0-0-0-0-4-0-0-0-0-4-0-0-0-0-4-0-0-0-0-4-0-0-0-0-4-0-0-0-0-4-0-0-0-0-4-0-0-0-0-4-0
e2a0c4b4e4e2a0c4b4e4e2a0c4b4e4e2a0c4b4e4e2a0c4b4e4e2a0c4b4e4e2a0c4b4e4e2a0c4b4e4e2a0c4b4e4e2a0c4b4e
0-0-2-4-2-0-0-2-4-2-0-0-2-4-2-0-0-2-4-2-0-0-2-4-2-0-0-2-4-2-0-0-2-4-2-0-0-2-4-2-0-0-2-4-2-0-0-2-4-2
e0b0c0a0e4e0b0c0a0e4e0b0c0a0e4e0b0c0a0e4e0b0c0a0e4e0b0c0a0e4e0b0c0a0e4e0b0c0a0e4e0b0c0a0e4e0b0c0a0e
3-4-0-4-4-3-4-0-4-4-3-4-0-4-4-3-4-0-4-4-3-4-0-4-4-3-4-0-4-4-3-4-0-4-4-3-4-0-4-4-3-4-0-4-4-3-4-0-4-4
c2a0b0b2e4c2a0b0b2e4c2a0b0b2e4c2a0b0b2e4c2a0b0b2e4c2a0b0b2e4c2a0b0b2e4c2a0b0b2e4c2a0b0b2e4c2a0b0b2e
2-2-2-2-2-2-2-2-2-2-2-2-2-2-2-2-2-2-2-2-2-2-2-2-2-2-2-2-2-2-2-2-2-2-2-2-2-2-2-2-2-2-2-2-2-2-2-2-2-2
e0b0b0b0e4e0b0b0b0e4e0b0b0b0e4e0b0b0b0e4e0b0b0b0e4e0b0b0b0e4e0b0b0b0e4e0b0b0b0e4e0b0b0b0e4e0b0b0b0e
0-0-0-4-0-0-0-0-4-0-0-0-0-4-0-0-0-0-4-0-0-0-0-4-0-0-0-0-4-0-0-0-0-4-0-0-0-0-4-0-0-0-0-4-0-0-0-0-4-0
e2a0c4b4e4e2a0c4b4e4e2a0c4b4e4e2a0c4b4e4e2a0c4b4e4e2a0c4b4e4e2a0c4b4e4e2a0c4b4e4e2a0c4b4e4e2a0c4b4e
0-0-2-4-2-0-0-2-4-2-0-0-2-4-2-0-0-2-4-2-0-0-2-4-2-0-0-2-4-2-0-0-2-4-2-0-0-2-4-2-0-0-2-4-2-0-0-2-4-2
e0b0c0a0e4e0b0c0a0e4e0b0c0a0e4e0b0c0a0e4e0b0c0a0e4e0b0c0a0e4e0b0c0a0e4e0b0c0a0e4e0b0c0a0e4e0b0c0a0e
4-4-4-4-4-4-4-4-4-4-4-4-4-4-4-4-4-4-4-4-4-4-4-4-4-4-4-4-4-4-4-4-4-4-4-4-4-4-4-4-4-4-4-4-4-4-4-4-4-4
a0b0c2d2e4a0b0c2d2e4a0b0c2d2e4a0b0c2d2e4a0b0c2d2e4a0b0c2d2e4a0b0c2d2e4a0b0c2d2e4a0b0c2d2e4a0b0c2d2e
3-4-0-4-4-3-4-0-4-4-3-4-0-4-4-3-4-0-4-4-3-4-0-4-4-3-4-0-4-4-3-4-0-4-4-3-4-0-4-4-3-4-0-4-4-3-4-0-4-4
c2a0b0b2e4c2a0b0b2e4c2a0b0b2e4c2a0b0b2e4c2a0b0b2e4c2a0b0b2e4c2a0b0b2e4c2a0b0b2e4c2a0b0b2e4c2a0b0b2e
2-2-2-2-2-2-2-2-2-2-2-2-2-2-2-2-2-2-2-2-2-2-2-2-2-2-2-2-2-2-2-2-2-2-2-2-2-2-2-2-2-2-2-2-2-2-2-2-2-2
e0b0b0b0e4e0b0b0b0e4e0b0b0b0e4e0b0b0b0e4e0b0b0b0e4e0b0b0b0e4e0b0b0b0e4e0b0b0b0e4e0b0b0b0e4e0b0b0b0e
0-0-0-4-0-0-0-0-4-0-0-0-0-4-0-0-0-0-4-0-0-0-0-4-0-0-0-0-4-0-0-0-0-4-0-0-0-0-4-0-0-0-0-4-0-0-0-0-4-0
e2a0c4b4e4e2a0c4b4e4e2a0c4b4e4e2a0c4b4e4e2a0c4b4e4e2a0c4b4e4e2a0c4b4e4e2a0c4b4e4e2a0c4b4e4e2a0c4b4e
0-0-2-4-2-0-0-2-4-2-0-0-2-4-2-0-0-2-4-2-0-0-2-4-2-0-0-2-4-2-0-0-2-4-2-0-0-2-4-2-0-0-2-4-2-0-0-2-4-2
e0b0c0a0e4e0b0c0a0e4e0b0c0a0e4e0b0c0a0e4e0b0c0a0e4e0b0c0a0e4e0b0c0a0e4e0b0c0a0e4e0b0c0a0e4e0b0c0a0e
3-4-0-4-4-3-4-0-4-4-3-4-0-4-4-3-4-0-4-4-3-4-0-4-4-3-4-0-4-4-3-4-0-4-4-3-4-0-4-4-3-4-0-4-4-3-4-0-4-4
c2a0b0b2e4c2a0b0b2e4c2a0b0b2e4c2a0b0b2e4c2a0b0b2e4c2a0b0b2e4c2a0b0b2e4c2a0b0b2e4c2a0b0b2e4c2a0b0b2e
2-2-2-2-2-2-2-2-2-2-2-2-2-2-2-2-2-2-2-2-2-2-2-2-2-2-2-2-2-2-2-2-2-2-2-2-2-2-2-2-2-2-2-2-2-2-2-2-2-2
e0b0b0b0e4e0b0b0b0e4e0b0b0b0e4e0b0b0b0e4e0b0b0b0e4e0b0b0b0e4e0b0b0b0e4e0b0b0b0e4e0b0b0b0e4e0b0b0b0e
0-0-0-4-0-0-0-0-4-0-0-0-0-4-0-0-0-0-4-0-0-0-0-4-0-0-0-0-4-0-0-0-0-4-0-0-0-0-4-0-0-0-0-4-0-0-0-0-4-0
e2a0c4b4e4e2a0c4b4e4e2a0c4b4e4e2a0c4b4e4e2a0c4b4e4e2a0c4b4e4e2a0c4b4e4e2a0c4b4e4e2a0c4b4e4e2a0c4b4e
0-0-2-4-2-0-0-2-4-2-0-0-2-4-2-0-0-2-4-2-0-0-2-4-2-0-0-2-4-2-0-0-2-4-2-0-0-2-4-2-0-0-2-4-2-0-0-2-4-2
e0b0c0a0e4e0b0c0a0e4e0b0c0a0e4e0b0c0a0e4e0b0c0a0e4e0b0c0a0e4e0b0c0a0e4e0b0c0a0e4e0b0c0a0e4e0b0c0a0e
4-4-4-4-4-4-4-4-4-4-4-4-4-4-4-4-4-4-4-4-4-4-4-4-4-4-4-4-4-4-4-4-4-4-4-4-4-4-4-4-4-4-4-4-4-4-4-4-4-4
a0b0c2d2e4a0b0c2d2e4a0b0c2d2e4a0b0c2d2e4a0b0c2d2e4a0b0c2d2e4a0b0c2d2e4a0b0c2d2e4a0b0c2d2e4a0b0c2d2e
3-4-0-4-4-3-4-0-4-4-3-4-0-4-4-3-4-0-4-4-3-4-0-4-4-3-4-0-4-4-3-4-0-4-4-3-4-0-4-4-3-4-0-4-4-3-4-0-4-4
c2a0b0b2e4c2a0b0b2e4c2a0b0b2e4c2a0b0b2e4c2a0b0b2e4c2a0b0b2e4c2a0b0b2e4c2a0b0b2e4c2a0b0b2e4c2a0b0b2e
2-2-2-2-2-2-2-2-2-2-2-2-2-2-2-2-2-2-2-2-2-2-2-2-2-2-2-2-2-2-2-2-2-2-2-2-2-2-2-2-2-2-2-2-2-2-2-2-2-2
e0b0b0b0e4e0b0b0b0e4e0b0b0b0e4e0b0b0b0e4e0b0b0b0e4e0b0b0b0e4e0b0b0b0e4e0b0b0b0e4e0b0b0b0e4e0b0b0b0e
0-0-0-4-0-0-0-0-4-0-0-0-0-4-0-0-0-0-4-0-0-0-0-4-0-0-0-0-4-0-0-0-0-4-0-0-0-0-4-0-0-0-0-4-0-0-0-0-4-0
e2a0c4b4e4e2a0c4b4e4e2a0c4b4e4e2a0c4b4e4e2a0c4b4e4e2a0c4b4e4e2a0c4b4e4e2a0c4b4e4e2a0c4b4e4e2a0c4b4e
0-0-2-4-2-0-0-2-4-2-0-0-2-4-2-0-0-2-4-2-0-0-2-4-2-0-0-2-4-2-0-0-2-4-2-0-0-2-4-2-0-0-2-4-2-0-0-2-4-2
e0b0c0a0e4e0b0c0a0e4e0b0c0a0e4e0b0c0a0e4e0b0c0a0e4e0b0c0a0e4e0b0c0a0e4e0b0c0a0e4e0b0c0a0e4e0b0c0a0e
3-4-0-4-4-3-4-0-4-4-3-4-0-4-4-3-4-0-4-4-3-4-0-4-4-3-4-0-4-4-3-4-0-4-4-3-4-0-4-4-3-4-0-4-4-3-4-0-4-4
c2a0b0b2e4c2a0b0b2e4c2a0b0b2e4c2a0b0b2e4c2a0b0b2e4c2a0b0b2e4c2a0b0b2e4c2a0b0b2e4c2a0b0b2e4c2a0b0b2e
2-2-2-2-2-2-2-2-2-2-2-2-2-2-2-2-2-2-2-2-2-2-2-2-2-2-2-2-2-2-2-2-2-2-2-2-2-2-2-2-2-2-2-2-2-2-2-2-2-2
e0b0b0b0e4e0b0b0b0e4e0b0b0b0e4e0b0b0b0e4e0b0b0b0e4e0b0b0b0e4e0b0b0b0e4e0b0b0b0e4e0b0b0b0e4e0b0b0b0e
0-0-0-4-0-0-0-0-4-0-0-0-0-4-0-0-0-0-4-0-0-0-0-4-0-0-0-0-4-0-0-0-0-4-0-0-0-0-4-0-0-0-0-4-0-0-0-0-4-0
e2a0c4b4e4e2a0c4b4e4e2a0c4b4e4e2a0c4b4e4e2a0c4b4e4e2a0c4b4e4e2a0c4b4e4e2a0c4b4e4e2a0c4b4e4e2a0c4b4e
0-0-2-4-2-0-0-2-4-2-0-0-2-4-2-0-0-2-4-2-0-0-2-4-2-0-0-2-4-2-0-0-2-4-2-0-0-2-4-2-0-0-2-4-2-0-0-2-4-2
e0b0c0a0e4e0b0c0a0e4e0b0c0a0e4e0b0c0a0e4e0b0c0a0e4e0b0c0a0e4e0b0c0a0e4e0b0c0a0e4e0b0c0a0e4e0b0c0a0e
4-4-4-4-4-4-4-4-4-4-4-4-4-4-4-4-4-4-4-4-4-4-4-4-4-4-4-4-4-4-4-4-4-4-4-4-4-4-4-4-4-4-4-4-4-4-4-4-4-4
a0b0c2d2e4a0b0c2d2e4a0b0c2d2e4a0b0c2d2e4a0b0c2d2e4a0b0c2d2e4a0b0c2d2e4a0b0c2d2e4a0b0c2d2e4a0b0c2d2e
3-4-0-4-4-3-4-0-4-4-3-4-0-4-4-3-4-0-4-4-3-4-0-4-4-3-4-0-4-4-3-4-0-4-4-3-4-0-4-4-3-4-0-4-4-3-4-0-4-4
c2a0b0b2e4c2a0b0b2e4c2a0b0b2e4c2a0b0b2e4c2a0b0b2e4c2a0b0b2e4c2a0b0b2e4c2a0b0b2e4c2a0b0b2e4c2a0b0b2e
2-2-2-2-2-2-2-2-2-2-2-2-2-2-2-2-2-2-2-2-2-2-2-2-2-2-2-2-2-2-2-2-2-2-2-2-2-2-2-2-2-2-2-2-2-2-2-2-2-2
e0b0b0b0e4e0b0b0b0e4e0b0b0b0e4e0b0b0b0e4e0b0b0b0e4e0b0b0b0e4e0b0b0b0e4e0b0b0b0e4e0b0b0b0e4e0b0b0b0e
0-0-0-4-0-0-0-0-4-0-0-0-0-4-0-0-0-0-4-0-0-0-0-4-0-0-0-0-4-0-0-0-0-4-0-0-0-0-4-0-0-0-0-4-0-0-0-0-4-0
e2a0c4b4e4e2a0c4b4e4e2a0c4b4e4e2a0c4b4e4e2a0c4b4e4e2a0c4b4e4e2a0c4b4e4e2a0c4b4e4e2a0c4b4e4e2a0c4b4e
0-0-2-4-2-0-0-2-4-2-0-0-2-4-2-0-0-2-4-2-0-0-2-4-2-0-0-2-4-2-0-0-2-4-2-0-0-2-4-2-0-0-2-4-2-0-0-2-4-2
e0b0c0a0e4e0b0c0a0e4e0b0c0a0e4e0b0c0a0e4e0b0c0a0e4e0b0c0a0e4e0b0c0a0e4e0b0c0a0e4e0b0c0a0e4e0b0c0a0e
3-4-0-4-4-3-4-0-4-4-3-4-0-4-4-3-4-0-4-4-3-4-0-4-4-3-4-0-4-4-3-4-0-4-4-3-4-0-4-4-3-4-0-4-4-3-4-0-4-4
c2a0b0b2e4c2a0b0b2e4c2a0b0b2e4c2a0b0b2e4c2a0b0b2e4c2a0b0b2e4c2a0b0b2e4c2a0b0b2e4c2a0b0b2e4c2a0b0b2e
2-2-2-2-2-2-2-2-2-2-2-2-2-2-2-2-2-2-2-2-2-2-2-2-2-2-2-2-2-2-2-2-2-2-2-2-2-2-2-2-2-2-2-2-2-2-2-2-2-2
e0b0b0b0e4e0b0b0b0e4e0b0b0b0e4e0b0b0b0e4e0b0b0b0e4e0b0b0b0e4e0b0b0b0e4e0b0b0b0e4e0b0b0b0e4e0b0b0b0e
0-0-0-4-0-0-0-0-4-0-0-0-0-4-0-0-0-0-4-0-0-0-0-4-0-0-0-0-4-0-0-0-0-4-0-0-0-0-4-0-0-0-0-4-0-0-0-0-4-0
e2a0c4b4e4e2a0c4b4e4e2a0c4b4e4e2a0c4b4e4e2a0c4b4e4e2a0c4b4e4e2a0c4b4e4e2a0c4b4e4e2a0c4b4e4e2a0c4b4e
0-0-2-4-2-0-0-2-4-2-0-0-2-4-2-0-0-2-4-2-0-0-2-4-2-0-0-2-4-2-0-0-2-4-2-0-0-2-4-2-0-0-2-4-2-0-0-2-4-2
e0b0c0a0e4e0b0c0a0e4e0b0c0a0e4e0b0c0a0e4e0b0c0a0e4e0b0c0a0e4e0b0c0a0e4e0b0c0a0e4e0b0c0a0e4e0b0c0a0e
4-4-4-4-4-4-4-4-4-4-4-4-4-4-4-4-4-4-4-4-4-4-4-4-4-4-4-4-4-4-4-4-4-4-4-4-4-4-4-4-4-4-4-4-4-4-4-4-4-4
a0b0c2d2e4a0b0c2d2e4a0b0c2d2e4a0b0c2d2e4a0b0c2d2e4a0b0c2d2e4a0b0c2d2e4a0b0c2d2e4a0b0c2d2e4a0b0c2d2e
3-4-0-4-4-3-4-0-4-4-3-4-0-4-4-3-4-0-4-4-3-4-0-4-4-3-4-0-4-4-3-4-0-4-4-3-4-0-4-4-3-4-0-4-4-3-4-0-4-4
c2a0b0b2e4c2a0b0b2e4c2a0b0b2e4c2a0b0b2e4c2a0b0b2e4c2a0b0b2e4c2a0b0b2e4c2a0b0b2e4c2a0b0b2e4c2a0b0b2e
2-2-2-2-2-2-2-2-2-2-2-2-2-2-2-2-2-2-2-2-2-2-2-2-2-2-2-2-2-2-2-2-2-2-2-2-2-2-2-2-2-2-2-2-2-2-2-2-2-2
e0b0b0b0e4e0b0b0b0e4e0b0b0b0e4e0b0b0b0e4e0b0b0b0e4e0b0b0b0e4e0b0b0b0e4e0b0b0b0e4e0b0b0b0e4e0b0b0b0e
0-0-0-4-0-0-0-0-4-0-0-0-0-4-0-0-0-0-4-0-0-0-0-4-0-0-0-0-4-0-0-0-0-4-0-0-0-0-4-0-0-0-0-4-0-0-0-0-4-0
e2a0c4b4e4e2a0c4b4e4e2a0c4b4e4e2a0c4b4e4e2a0c4b4e4e2a0c4b4e4e2a0c4b4e4e2a0c4b4e4e2a0c4b4e4e2a0c4b4e
0-0-2-4-2-0-0-2-4-2-0-0-2-4-2-0-0-2-4-2-0-0-2-4-2-0-0-2-4-2-0-0-2-4-2-0-0-2-4-2-0-0-2-4-2-0-0-2-4-2
e0b0c0a0e4e0b0c0a0e4e0b0c0a0e4e0b0c0a0e4e0b0c0a0e4e0b0c0a0e4e0b0c0a0e4e0b0c0a0e4e0b0c0a0e4e0b0c0a0e