20 20
a0c0b0a2c2b0d0a2d0a0a0d4a4c0a0a4a4b2a0a
2-0-4-0-0-0-2-2-0-0-0-0-0-0-0-2-2-0-2-0
a0c0e2a0c0b2c2c2c0b0b2a2b2d0c2b2a0c2a0d
0-2-0-0-0-2-0-0-0-0-0-4-0-4-0-0-4-2-0-0
d0a0a0b0a4b0b0c0b2a4a2d0c0d0c0b0c0a0b2a
0-2-0-2-0-2-0-0-0-0-0-0-2-2-0-2-2-0-0-4
c0d0a2b0a2b2b2a0a0c2b0c0a0b0c4a2c2a2e2b
0-2-2-2-0-0-2-2-0-0-2-0-0-0-0-2-2-2-0-2
b2a4b0a0d0d0a2d4d0a0a2b0c0a0a0b0a0b4b0a
2-0-2-2-0-4-0-2-0-2-0-0-2-2-2-0-0-0-2-2
b0b0c0e0a0b0a0c0b0c4a2a0a2a0a2b0b0d4a0b
0-0-0-4-0-2-0-0-0-2-4-0-2-0-2-0-2-0-0-0
b0b0a0b2b2b0e2a4c0b0c2d4c2c0a0b0b0b2b2a
2-0-4-0-4-2-2-0-2-2-2-0-0-0-0-0-0-2-0-0
e0a0b0b0a0c0d0b2a0c0a0c0a0e2a0b2a4e0c0d
2-4-0-4-0-0-0-0-0-2-0-0-0-0-0-2-0-2-0-0
a0b0a2e0a0b0a4c2c2b2d0a2a0a2d0a0c0d0b0a
0-0-2-0-0-0-2-2-2-0-0-4-4-4-0-0-0-0-0-2
b0c4a0c0b0a0b0a0c0a2b0a0c2a0a0c0b0b0a0a
0-2-0-4-4-4-2-2-2-0-0-2-0-2-0-0-2-0-0-0
c4b4a0a0b4b2c2a0d0b2b0a0a0a2a2c0a0c2a0a
2-0-0-2-4-0-2-2-4-2-4-0-2-2-0-4-0-0-2-0
a2e4a0a0d2d0a0b0b0a2e0b2b2c0b2b0b0a2b2b
0-0-4-0-0-0-2-0-0-2-0-2-2-0-0-0-0-0-2-2
a2c4a0b0a0a2e2a4b0d0c0c0c2e2b0c0a0a0a0b
0-0-4-2-0-2-0-0-0-0-0-0-0-0-0-0-2-2-2-2
b4d4c0a0a0b0a2a0a0b0a2b0a0c0c0a0c0a0b0a
0-2-0-0-2-0-2-0-0-0-0-2-2-0-2-0-0-0-2-0
e2b0c0c0a4a0b0a0a2a0e0e2a0c4d0b4b2a0c2a
0-0-0-0-4-0-2-0-0-0-2-0-0-2-0-2-0-2-0-0
c0a4a2a4a0b4b2a0c0e2b0c4a2b4a0c0d0c0a0d
0-0-0-2-0-2-0-4-2-4-0-2-2-0-0-0-0-0-0-2
c0e0a0a2a2b0b0a0d0b0c0a0d0a0c0a2d4c0b2a
0-0-0-0-2-0-4-0-0-0-0-0-2-0-0-2-0-4-0-0
a4a2b2b0b4b2a0b2b0a0c4a0d0a0b2a4a0d0a0a
0-4-2-4-0-0-0-4-0-0-0-4-0-0-4-0-2-2-0-4
b0b0a0b0c0a0a0b0e0b0c2b2a2a2a0a0a0a2d0a
4-2-0-2-4-0-0-0-4-0-0-2-2-2-2-2-2-0-2-0
a0a0a0a2d0d0b0c0d0a4a2b0a0a0e0c2c0b2c0a